1111111111111
1111111111111
110B0B0B0B011
1111111111111
111PCCE111111
1111111111111