11111111111111111111111
100C01100000C010B010001
10100100010001000100011
1P101000100100001001001
101001010000110C00010C1
101000C010001010001E101
1C1B000100C111111000111
11111111111111111111111