111111111111111111111111111111
10000P10000C00000000010C001101
100000101111110100000100001101
100111100000010010000111000111
1000001010000100010000010000E1
100000111000010001000010000111
100000000000010001000100001101
100C00100000100001000000001101
100011100C01000C010000000C1101
111111111111111111111111111111