11111111111111
100P000000C001
10000100000001
1000010000E001
11111111111111