11111111111111
1ffPf00000C001
1ffff100000001
1ffff10000E001
11111111111111